7,9

##########
###*****&#
###****###
##*****###
##@#######
##$#######
##########